R 200 3000
NO ./textures/bluestone.xpm
SO ./textures/mossy.xpm
WE ./textures/colorstone.xpm
EA ./textures/greystone.xpm

S ./textures/barrel.xpm
F 24,85,2
C 29,25,01

1111111111111111111111111111
10000    00000000000000000000001
1E0000200000200    000020001
1000000000000000000000000001
1000000000000000020000000001
1111111111111111111111111111
