R	3640	2160

NO ./textures/mossy.xpm
SO ./textures/redbrick.xpm
EA ./textures/stone.xpm
WE ./textures/wood.xpm
S ./textures/barrel.xpm

F 117, 142, 79
C 135, 245, 251


111111111111111111111111111111111111111111111111111111111111111111111111111111111111111111111111111111111111111111111111111111
100000000000000000000000000000001000000000000000000000000000000001000000000000000000000000000000000000000100000000000000000001
1000000000000000000000000000000000000000000000000000000000000000010000000000000000000000000000000000000001000000000020000000W1
100000000000000000000000000000001000000000000000000000000000000000000000000000000000000000000000000000000100000000000000000001
100000000000000000000000000000001000000000000000000000000000000001000000000000000000000000000000000000000000000000000000000001
100001111111111111111111111111111111111111111111111111111111111111111111111111111111111111111111111111111111111111111111111111
100001
100001
100001
100001
100001
100001
100000111111111111111111111111111111111111111111111111111111111111111111111111111111111111111111111111111111111111111111111111111
100000000000000000000000000000000002222222222222222222200000000022222222222222222200000000000000000000000000000000000000000000001
100000000000000000000000000000000000000000000000000000000000000000000000000000000000000000000000000000000000000000000000000000001
100000000000000000000000000000000000000000000000000000000000000000000000000000000000000000000000000000000000000000000000000000001
100000000000000000000000000000000000000000000000000002000000000000000000000000000000000000000000000000000000000000000000000000001
100000000000000000000000000000000000000000000000000021200000000000000000000000000000000000000000000000000000000000000000000000001
100000000000000000000000000000000000000000000000000002000000000000000000000000000000000000000000000000000000000000000000000000001
100000000000000000000000000000000000000000000000000000000000000000000000000000000000000000000000000000000000000000000000000000001
100000000000000000000000000000000000000000000000000000000000000000000000000000000000000000000000000000000000000000000000000000001
100000000000000000000000000000000000000000000000000000000000000000000000000000000000000000000000000000000000000000000000000000001
100000000000000000000001111111111111111111111111120201111111111111111111111111100000000000000000000000000000000000000000000000001
100000000000000000000001000000000000000000000000200002000000000000000000000000100000000000000000000000000000000000000000000000001
100000000000000000000001000000000000000000000002000000200000000000000000000000100000000000000000000000000000000000000000000000001
100000000000000000000001000000000000000000000000000000000000000000000000000000100000000000000000000000000000000000000000000000001
100000000000000000000001000000000000000000000011111111110000000000000000000000100000000000000000000000000000000000000000000000001
100000000000000000000001000000000000000000000000000000000000000000000000000000100000000000000000000000000000000000000000000000001
100000000000000000000001111111111111111111111111111111111111111111111111111111100000000000000000000000000000000000000000000000001
100000000000000000000000222222222222222222222222222222222222222222222222222222000000000000000000000000000000000000000000000000001
100000000000000000000000000000000000000000000000000000000000000000000000000000000000000000000000000000000000000000000000000000001
100000000000000000000000000000000000000000000000000000000000000000000000000000000000000000000000000000000000000000000000000000001
111111111111111111111111111111111111111111111111111111111111111111111111111111111111111111111111111111111111111111111111111111111
